[Grid Size]
20 20
[Tile Map]
2,2,2,2,2    ;2,2,2,2,2    ;2,2,2,2,2    ;2,2,2,2,2    ;2,2,2    ;2,2,2    ;2,2,2    ;2,2,2    ;2,2,2    ;2,2,2    ;2,2,2    ;2,2,2   ;2,2,2    ;2    ;2    ;2    ;2    ;2    ;2    ;2    
2,2,2,2,2    ;2,2,2,2,2    ;2,2,2,2,2    ;2,2,2,2,2    ;2,2,2    ;2,2,2    ;2,2,2    ;2,2,2    ;2,2,2    ;2,2,2    ;2,2,2    ;2,2,2   ;2,2,2    ;2    ;2    ;2    ;1    ;1    ;1    ;1    
1,1,1,1,1    ;1,1,1,1,1    ;2,2,2,2,2    ;2,2,2,2,2    ;2,2,2    ;2,2,2    ;2,2,2    ;2,2,2    ;1,1,1    ;1,1,1    ;2,2,2    ;2,2,2    ;2       ;2    ;1    ;1    ;1    ;1    ;1    ;1    
1,1,1,1,1    ;1,1,1,1,1    ;1,1,1,1,1    ;1,1,1,1    ;1,1,1,1    ;1,1,1,1    ;1,1,1    ;1,1,1    ;1,1,1    ;1,1,1    ;1,1,1    ;1,1    ;1,1    ;1    ;1    ;1    ;2    ;3    ;3    ;3    
2,2,2,2,2    ;2,2,2,2,2    ;1,1,1,1,1    ;1,1,1,1    ;1,1,1,1    ;1,1,1,1    ;1,1,1    ;1,1,1    ;2,2,2    ;2,2,2    ;1,1,1    ;1,1    ;1,1    ;1    ;2    ;3    ;3    ;3    ;2    ;2    
2,2,2,2,2    ;2,2,2,2,2    ;2,2,2,2,2    ;2,2,2,2,2    ;2,2,2,2,2    ;2,2,2    ;2,2,2    ;2,2,2    ;2,2,2    ;2,2,2    ;2,2,2    ;3    ;3    ;3    ;3    ;3    ;2    ;2    ;2    ;2    
2,2,2,2,2    ;2,2,2,2,2    ;2,2,2,2,2    ;2,2,2,2,2    ;2,2,2,2,2    ;2,2,2    ;2,2,2    ;2,2,2    ;3,3      ;3,3      ;3,3      ;3,3    ;3    ;4,4    ;2    ;2    ;2    ;2    ;2    ;2    
2,2,2,2,2    ;2,2,2,2,2    ;2,2,2,2,2    ;2,2,2,2,2    ;2,2,2,2,2    ;3,3,3    ;3,3      ;3,3      ;3,3      ;4,4,4    ;4,4,4    ;3    ;3    ;4,4    ;2    ;2    ;2    ;2    ;2    ;2    
2,2,2,2,2    ;2,2,2,2,2    ;3,3,3,3      ;3,3,3,3      ;3,3,3,3      ;3,3,3    ;4,4,4,4    ;4,4,4    ;4,4,4    ;4,4,4    ;4,4,4   ;4,4,4 ;4,4    ;2    ;2    ;2    ;2    ;2    ;2    ;2    
3,3,3,3      ;3,3,3,3      ;3,3,3,3      ;3,3,3,3      ;3,3,3,3     ;4,4,4,4,4 ;4,4,4,4    ;4,4,4    ;4,4,4    ;4,4,4    ;4,4,4    ;4,4,4   ;4,4,4 ;2    ;2    ;2    ;2    ;2    ;2    ;2    
2,2,2,2,2    ;2,2,2,2,2    ;2,2,2,2,2    ;2,2,2,2,2    ;3,3,3,3      ;3,3,3    ;4,4,4,4    ;4,4,4    ;4,4,4    ;4,4,4    ;4,4,4    ;4,4,4   ;4,4,4 ;2    ;2    ;2    ;3    ;3    ;3    ;3    
2,2,2,2,2    ;2,2,2,2,2    ;2,2,2,2,2    ;2,2,2,2,2    ;2,2,2,2,2    ;3,3,3    ;3,3      ;3,3      ;3,3      ;3,3      ;3,3      ;4,4,4    ;3,3    ;3    ;3    ;3    ;3    ;2    ;2    ;2    
2,2,2,2,2    ;2,2,2,2,2    ;2,2,2,2,2    ;2,2,2,2,2    ;2,2,2,2,2   ;2,2,2    ;2,2,2    ;2,2,2    ;2,2,2    ;2,2,2    ;3,3      ;3,3      ;3,3    ;4,4  ;2    ;2    ;2    ;2    ;2    ;2    
2,2,2,2,2    ;2,2,2,2,2    ;2,2,2,2,2    ;2,2,2,2,2    ;2,2,2,2,2   ;2,2,2,2,2 ;2,2,2    ;2,2,2    ;2,2,2    ;2,2,2    ;2,2,2    ;2,2,2    ;3    ;3    ;3    ;3    ;3    ;3    ;2    ;2    
2,2,2,2,2    ;2,2,2,2,2    ;2,2,2,2,2    ;2,2,2,2,2    ;2,2,2,2,2   ;2,2,2,2,2 ;2,2,2    ;1,1,1    ;1,1,1    ;2,2,2    ;2,2,2    ;2,2,2    ;2    ;2    ;2    ;2    ;2    ;3    ;3    ;3    
2,2,2,2,2    ;2,2,2,2,2    ;2,2,2,2,2    ;2,2,2,2,2    ;2,2,2,2,2    ;2,2,2    ;1,1,1    ;1,1,1    ;1,1,1    ;1,1,1    ;2,2,2    ;2,2    ;2    ;2    ;2    ;2    ;2    ;2    ;2    ;2    
2,2,2,2,2    ;1,1,1,1,1    ;1,1,1,1,1    ;1,1,1,1      ;1,1,1,1    ;1,1,1,1    ;1,1,1    ;1,1,1    ;1,1,1    ;1,1,1    ;1,1    ;1,1    ;1    ;1    ;1    ;2    ;2    ;2    ;2    ;2    
1,1,1,1,1    ;1,1,1,1,1    ;1,1,1,1,1    ;1,1,1,1      ;1,1,1,1    ;1,1,1,1    ;2,2,2    ;2,2,2    ;2,2,2    ;2,2,2    ;1,1    ;1,1    ;1    ;1    ;1    ;1    ;1    ;1    ;1    ;1    
1,1,1,1,1    ;2,2,2,2,2    ;2,2,2,2,2    ;2,2,2,2,2    ;2,2,2,2,2    ;2,2,2    ;2,2,2    ;2,2,2    ;2,2,2    ;2,2,2    ;2,2,2    ;2    ;2    ;2    ;2    ;1    ;1    ;1    ;1    ;1    
2,2,2,2,2    ;2,2,2,2,2    ;2,2,2,2,2    ;2,2,2,2,2    ;2,2,2,2,2    ;2,2,2    ;2,2,2    ;2,2,2    ;2,2,2    ;2,2,2    ;2,2,2    ;2    ;2    ;2    ;2    ;2    ;2    ;2    ;2    ;2    
[Object Map]
0 ;0 ;0 ;0 ;0 ;0 ;0 ;0 ;0 ;0 ;0 ;0 ;0 ;0 ;0 ;0 ;0 ;0 ;0 ;0
0 ;0 ;0 ;0 ;0 ;0 ;0 ;0 ;0 ;0 ;0 ;0 ;0 ;0 ;0 ;0 ;0 ;0 ;0 ;0
0 ;0 ;0 ;0 ;0 ;0 ;0 ;0 ;0 ;0 ;0 ;0 ;0 ;0 ;0 ;0 ;0 ;0 ;0 ;0
0 ;0 ;0 ;0 ;0 ;0 ;0 ;0 ;0 ;0 ;0 ;0 ;0 ;0 ;0 ;0 ;0 ;0 ;0 ;0
0 ;0 ;0 ;0 ;0 ;0 ;0 ;0 ;0 ;0 ;0 ;0 ;0 ;0 ;0 ;0 ;0 ;0 ;0 ;0
0 ;0 ;0 ;0 ;0 ;0 ;0 ;0 ;0 ;0 ;0 ;0 ;0 ;0 ;0 ;0 ;0 ;0 ;0 ;0
0 ;0 ;0 ;0 ;0 ;0 ;0 ;0 ;0 ;0 ;0 ;0 ;0 ;0 ;0 ;0 ;0 ;0 ;0 ;0
0 ;0 ;0 ;0 ;0 ;0 ;0 ;0 ;0 ;0 ;0 ;0 ;0 ;0 ;0 ;0 ;0 ;0 ;0 ;0
0 ;0 ;0 ;0 ;0 ;0 ;0 ;0 ;0 ;0 ;0 ;0 ;0 ;0 ;0 ;0 ;0 ;0 ;0 ;0
0 ;0 ;0 ;0 ;0 ;0 ;0 ;0 ;0 ;0 ;0 ;0 ;0 ;0 ;0 ;0 ;0 ;0 ;0 ;0
0 ;1 ;0 ;0 ;0 ;0 ;0 ;0 ;0 ;0 ;0 ;0 ;0 ;0 ;0 ;0 ;0 ;2 ;0 ;0
0 ;0 ;0 ;0 ;0 ;0 ;2 ;0 ;0 ;0 ;0 ;0 ;0 ;0 ;0 ;0 ;0 ;0 ;0 ;0
0 ;0 ;0 ;0 ;0 ;0 ;0 ;0 ;0 ;0 ;0 ;3 ;0 ;0 ;0 ;0 ;0 ;0 ;0 ;0
0 ;0 ;0 ;0 ;0 ;0 ;0 ;0 ;0 ;0 ;0 ;0 ;0 ;0 ;0 ;0 ;0 ;0 ;0 ;0
0 ;0 ;0 ;0 ;0 ;0 ;0 ;0 ;0 ;0 ;0 ;0 ;0 ;0 ;0 ;0 ;0 ;0 ;0 ;0
0 ;0 ;0 ;0 ;0 ;0 ;0 ;0 ;0 ;0 ;0 ;0 ;0 ;0 ;0 ;0 ;0 ;0 ;0 ;0
0 ;0 ;0 ;0 ;0 ;0 ;0 ;0 ;0 ;0 ;0 ;0 ;0 ;0 ;0 ;0 ;0 ;4 ;0 ;0
0 ;0 ;0 ;0 ;0 ;0 ;0 ;0 ;0 ;0 ;0 ;0 ;0 ;0 ;0 ;0 ;0 ;0 ;0 ;0
0 ;0 ;0 ;0 ;0 ;0 ;0 ;0 ;0 ;0 ;0 ;0 ;0 ;0 ;0 ;0 ;0 ;0 ;0 ;0
0 ;0 ;0 ;0 ;0 ;0 ;0 ;0 ;0 ;0 ;0 ;0 ;0 ;0 ;0 ;0 ;0 ;0 ;0 ;0