[Grid Size]
30 ;30
[Tile Map]
23    ;23    ;23    ;23    ;23    ;23    ;13    ;6     ;6       ;6        ;13       ;23    ;23    ;23    ;23    ;23    ;23    ;23    ;23    ;23    ;23    ;23    ;23    ;23    ;23    ;23    ;23    ;23     ;23    ;23
23    ;23    ;23    ;23    ;23    ;23    ;13    ;6     ;6       ;6        ;13       ;23    ;23    ;23    ;23    ;22    ;22    ;23    ;23    ;23    ;23    ;23    ;23    ;23    ;23    ;23    ;23    ;23     ;23    ;23
23    ;23    ;42    ;23    ;23    ;23    ;13    ;6     ;6       ;6        ;13       ;23    ;23    ;23    ;23    ;23    ;23    ;23    ;23    ;23    ;23    ;23    ;23    ;23    ;23    ;23    ;23    ;23     ;23    ;23
23    ;23    ;31    ;22    ;23    ;23    ;23    ;13    ;6       ;6        ;6        ;13    ;23    ;23    ;23    ;23    ;23    ;23    ;23    ;23    ;23    ;23    ;23    ;23    ;23    ;23    ;23    ;23     ;23    ;23
23    ;23    ;22    ;23    ;23    ;23    ;23    ;23    ;13      ;6        ;6        ;6     ;13    ;23    ;23    ;23    ;23    ;23    ;23    ;23    ;23    ;23    ;23    ;23    ;23    ;23    ;23    ;23     ;23    ;23
23    ;23    ;23    ;23    ;23    ;23    ;23    ;23    ;13      ;6        ;6        ;6     ;13    ;23    ;23    ;23    ;43    ;34    ;23    ;23    ;23    ;23    ;23    ;23    ;23    ;23    ;23    ;23     ;23    ;23
23    ;23    ;23    ;23    ;23    ;23    ;23    ;23    ;6       ;6        ;6        ;6     ;13    ;23    ;23    ;34    ;34    ;23    ;23    ;23    ;23    ;23    ;23    ;23    ;23    ;23    ;23    ;23     ;23    ;23
23    ;23    ;23    ;23    ;23    ;23    ;23    ;13    ;6       ;6        ;6        ;13    ;23    ;23    ;23    ;23    ;23    ;23    ;23    ;23    ;23    ;23    ;23    ;23    ;23    ;23    ;23    ;23     ;23    ;23
23    ;23    ;23    ;23    ;23    ;23    ;13    ;6     ;6       ;6        ;13       ;23    ;23    ;23    ;23    ;23    ;23    ;23    ;23    ;23    ;23    ;23    ;23    ;23    ;23    ;23    ;23    ;23     ;23    ;23
46    ;46    ;46    ;46    ;46    ;46    ;46    ;46    ;46      ;46       ;46       ;46    ;46    ;46    ;46    ;46    ;46    ;46    ;46    ;46    ;46    ;46    ;46    ;46    ;46    ;46    ;46    ;46     ;46    ;46 
25    ;25    ;25    ;25    ;25    ;25    ;25    ;25    ;25      ;25       ;25       ;25    ;25    ;25    ;25    ;25    ;25    ;25    ;25    ;25    ;25    ;25    ;25    ;25    ;25    ;25    ;25    ;25     ;25    ;25   
25    ;25    ;25    ;25    ;25    ;25    ;25    ;25    ;25      ;25       ;25       ;25    ;25    ;25    ;25    ;25    ;25    ;25    ;25    ;25    ;25    ;25    ;25    ;25    ;25    ;25    ;25    ;25     ;25    ;25   
25    ;25    ;25    ;25    ;25    ;25    ;25    ;25    ;25      ;25       ;25       ;25    ;25    ;25    ;25    ;25    ;25    ;25    ;25    ;25    ;25    ;25    ;25    ;25    ;25    ;25    ;25    ;25     ;25    ;25
46    ;46    ;46    ;46    ;46    ;46    ;46    ;46    ;46      ;46       ;46       ;46    ;46    ;46    ;46    ;46    ;46    ;46    ;46    ;46    ;46    ;46    ;46    ;46    ;46    ;46    ;46    ;46     ;46    ;46 
23    ;23    ;23    ;23    ;23    ;23    ;23    ;13    ;6       ;6        ;6        ;13    ;23    ;23    ;23    ;23    ;23    ;23    ;23    ;23    ;23    ;24    ;24    ;23    ;23    ;23    ;23    ;23     ;23    ;23  
23    ;23    ;23    ;23    ;23    ;32    ;23    ;13    ;6       ;6        ;6        ;13    ;23    ;23    ;23    ;23    ;23    ;23    ;23    ;23    ;23    ;24    ;24    ;24    ;23    ;23    ;23    ;23     ;23    ;23  
23    ;23    ;32    ;32    ;23    ;23    ;23    ;23    ;13      ;6        ;6        ;6     ;13    ;23    ;23    ;23    ;23    ;23    ;23    ;23    ;23    ;23    ;24    ;24    ;23    ;23    ;23    ;23     ;23    ;23  
23    ;23    ;23    ;32    ;23    ;23    ;23    ;23    ;13      ;6        ;6        ;6     ;13    ;23    ;23    ;23    ;22    ;22    ;23    ;23    ;23    ;23    ;24    ;24    ;23    ;23    ;23    ;23     ;23    ;23 
23    ;23    ;23    ;23    ;23    ;23    ;23    ;23    ;13      ;6        ;6        ;6     ;13    ;23    ;23    ;23    ;23    ;23    ;23    ;23    ;23    ;23    ;23    ;24    ;24    ;23    ;23    ;23     ;23    ;23
22    ;22    ;23    ;23    ;23    ;23    ;13    ;13    ;6       ;6        ;6        ;6     ;13    ;22    ;22    ;23    ;23    ;23    ;23    ;23    ;23    ;23    ;23    ;24    ;24    ;23    ;23    ;23     ;23    ;24  
22    ;22    ;23    ;23    ;23    ;23    ;13    ;13    ;6       ;6        ;6        ;6     ;13    ;22    ;22    ;23    ;23    ;23    ;23    ;23    ;23    ;23    ;23    ;23    ;24    ;24    ;23    ;24     ;24    ;24
22    ;22    ;23    ;23    ;23    ;13    ;13    ;6     ;6       ;6        ;6        ;6     ;13    ;13    ;22    ;23    ;23    ;23    ;23    ;23    ;23    ;23    ;23    ;23    ;24    ;24    ;24    ;24     ;24    ;23
22    ;22    ;23    ;23    ;23    ;13    ;13    ;6     ;6       ;6        ;6        ;6     ;13    ;13    ;22    ;23    ;23    ;23    ;23    ;23    ;23    ;23    ;23    ;23    ;23    ;24    ;24    ;24     ;22    ;23
22    ;22    ;23    ;23    ;23    ;13    ;13    ;6     ;6       ;5        ;5        ;6     ;6     ;13    ;13    ;23    ;23    ;23    ;23    ;23    ;23    ;23    ;23    ;23    ;23    ;24    ;24    ;22     ;23    ;23
22    ;22    ;23    ;23    ;23    ;13    ;13    ;6     ;6       ;25       ;46       ;6     ;6     ;13    ;13    ;23    ;23    ;23    ;23    ;23    ;23    ;23    ;23    ;23    ;23    ;23    ;24    ;24     ;23    ;23
22    ;22    ;23    ;23    ;13    ;13    ;6     ;6     ;6       ;25       ;25       ;6     ;6     ;13    ;13    ;23    ;23    ;23    ;23    ;23    ;23    ;23    ;23    ;23    ;23    ;23    ;24    ;24     ;23    ;23
22    ;22    ;23    ;23    ;13    ;13    ;6     ;6     ;15      ;25       ;15       ;6     ;6     ;13    ;13    ;23    ;23    ;23    ;23    ;23    ;23    ;23    ;23    ;23    ;23    ;23    ;23    ;24     ;24    ;23
22    ;22    ;23    ;23    ;13    ;13    ;6     ;6     ;15      ;46       ;15       ;5     ;6     ;6     ;13    ;13    ;23    ;23    ;23    ;23    ;23    ;23    ;23    ;23    ;23    ;23    ;23    ;24     ;24    ;23
22    ;22    ;23    ;13    ;13    ;6     ;6     ;6     ;15      ;46       ;15       ;5     ;6     ;6     ;13    ;13    ;23    ;23    ;23    ;23    ;23    ;23    ;23    ;23    ;23    ;23    ;23    ;23     ;24    ;24
22    ;22    ;23    ;13    ;13    ;6     ;6     ;6     ;15      ;25       ;15       ;5     ;6     ;6     ;13    ;13    ;23    ;23    ;23    ;23    ;23    ;23    ;23    ;23    ;23    ;23    ;23    ;23     ;24    ;24
[Object Map]
0 ;0 ;0 ;0 ;0 ;0 ;0 ;0 ;0 ;0 ;0 ;0 ;0 ;0 ;0 ;0 ;0 ;0 ;0 ;0
0 ;0 ;0 ;0 ;0 ;0 ;0 ;0 ;0 ;0 ;0 ;0 ;0 ;0 ;0 ;0 ;0 ;0 ;0 ;0
0 ;0 ;0 ;0 ;0 ;0 ;0 ;0 ;0 ;0 ;0 ;0 ;0 ;0 ;0 ;0 ;0 ;0 ;0 ;0
0 ;0 ;0 ;0 ;0 ;0 ;0 ;0 ;0 ;0 ;0 ;0 ;0 ;0 ;0 ;0 ;0 ;0 ;0 ;0
0 ;0 ;0 ;0 ;0 ;0 ;0 ;0 ;0 ;0 ;0 ;0 ;0 ;0 ;0 ;0 ;0 ;0 ;0 ;0
0 ;0 ;0 ;0 ;0 ;0 ;0 ;0 ;0 ;0 ;0 ;0 ;0 ;0 ;0 ;0 ;0 ;0 ;0 ;0
0 ;0 ;0 ;0 ;0 ;0 ;0 ;0 ;0 ;0 ;0 ;0 ;0 ;0 ;0 ;0 ;0 ;0 ;0 ;0
0 ;0 ;0 ;0 ;0 ;0 ;0 ;0 ;0 ;0 ;0 ;0 ;0 ;0 ;0 ;0 ;0 ;0 ;0 ;0
0 ;0 ;0 ;0 ;0 ;0 ;0 ;0 ;0 ;0 ;0 ;0 ;0 ;0 ;0 ;0 ;0 ;0 ;0 ;0
0 ;0 ;0 ;0 ;0 ;0 ;0 ;0 ;0 ;0 ;0 ;0 ;0 ;0 ;0 ;0 ;0 ;0 ;0 ;0
0 ;1 ;0 ;0 ;0 ;0 ;0 ;0 ;0 ;0 ;0 ;0 ;0 ;0 ;0 ;0 ;0 ;2 ;0 ;0
0 ;0 ;0 ;0 ;0 ;0 ;2 ;0 ;0 ;0 ;0 ;0 ;0 ;0 ;0 ;0 ;0 ;0 ;0 ;0
0 ;0 ;0 ;0 ;0 ;0 ;0 ;0 ;0 ;0 ;0 ;3 ;0 ;0 ;0 ;0 ;0 ;0 ;0 ;0
0 ;0 ;0 ;0 ;0 ;0 ;0 ;0 ;0 ;0 ;0 ;0 ;0 ;0 ;0 ;0 ;0 ;0 ;0 ;0
0 ;0 ;0 ;0 ;0 ;0 ;0 ;0 ;0 ;0 ;0 ;0 ;0 ;0 ;0 ;0 ;0 ;0 ;0 ;0
0 ;0 ;0 ;0 ;0 ;0 ;0 ;0 ;0 ;0 ;0 ;0 ;0 ;0 ;0 ;0 ;0 ;0 ;0 ;0
0 ;0 ;0 ;0 ;0 ;0 ;0 ;0 ;0 ;0 ;0 ;0 ;0 ;0 ;0 ;0 ;0 ;4 ;0 ;0
0 ;0 ;0 ;0 ;0 ;0 ;0 ;0 ;0 ;0 ;0 ;0 ;0 ;0 ;0 ;0 ;0 ;0 ;0 ;0
0 ;0 ;0 ;0 ;0 ;0 ;0 ;0 ;0 ;0 ;0 ;0 ;0 ;0 ;0 ;0 ;0 ;0 ;0 ;0
0 ;0 ;0 ;0 ;0 ;0 ;0 ;0 ;0 ;0 ;0 ;0 ;0 ;0 ;0 ;0 ;0 ;0 ;0 ;0