[Grid Size]
20 20
[Height Map]
3 3 3 3 3 3 2 1 1 1 2 3 3 3 3 3 3 3 3 3
3 3 3 3 3 3 2 1 1 1 2 3 3 3 3 3 3 3 3 3
3 3 3 5 3 3 2 1 1 1 2 3 3 3 3 3 3 3 3 3
3 3 3 4 4 3 3 2 1 1 1 2 3 3 3 3 3 3 3 3
3 3 3 4 3 3 3 3 2 1 1 1 2 3 3 3 3 3 3 3
3 3 3 3 3 3 3 3 2 1 1 1 2 3 3 3 5 4 3 3
3 3 3 3 3 3 3 3 2 1 1 1 2 3 3 4 4 3 3 3
3 3 3 3 3 3 3 2 1 1 1 2 3 3 3 3 3 3 3 3 
3 3 3 3 3 3 2 1 1 1 2 3 3 3 3 3 3 3 3 3
4 4 4 4 4 4 4 4 4 4 4 4 4 4 4 4 4 4 4 4
3 3 3 3 3 3 3 3 3 3 3 3 3 3 3 3 3 3 3 3
3 3 3 3 3 3 3 3 3 3 3 3 3 3 3 3 3 3 3 3
3 3 3 3 3 3 3 3 3 3 3 3 3 3 3 3 3 3 3 3
4 4 4 4 4 4 4 4 4 4 4 4 4 4 4 4 4 4 4 4
3 3 3 3 3 3 3 2 1 1 1 2 3 3 3 3 3 3 3 3
3 3 3 3 3 4 3 2 1 1 1 2 3 3 3 3 3 3 3 3
3 3 4 4 3 3 3 3 2 1 1 1 2 3 3 3 3 3 3 3
3 3 3 4 3 3 3 3 2 1 1 1 2 3 3 3 4 4 3 3
3 3 3 3 3 3 3 3 2 1 1 1 2 3 3 3 3 3 3 3
3 3 3 3 3 3 3 3 2 1 1 1 2 3 3 3 3 3 3 3
[Tile Type]
1 1 1 1 1 1 2 4 4 4 2 1 1 1 1 1 1 1 1 1
1 1 1 1 1 1 2 4 4 4 2 1 1 1 1 2 2 1 1 1
1 1 1 1 1 1 2 4 4 4 2 1 1 1 1 1 1 1 1 1
1 2 2 1 1 1 1 2 4 4 4 2 1 1 1 1 1 1 1 1
1 1 2 1 1 1 1 1 2 4 4 4 2 1 1 1 1 1 1 1
1 1 1 1 1 1 1 1 2 4 4 4 2 2 1 2 1 1 1 1
1 1 1 1 1 1 1 1 2 4 4 4 2 1 1 1 1 1 1 1
1 1 1 1 1 1 1 2 4 4 4 2 1 1 1 1 1 1 1 1
1 1 1 1 1 1 2 4 4 4 2 1 1 1 1 1 1 1 1 1
3 3 3 3 3 3 3 3 3 3 3 3 3 3 3 3 3 3 3 3
3 3 3 3 3 3 3 3 3 3 3 3 3 3 3 3 3 3 3 3
3 3 3 3 3 3 3 3 3 3 3 3 3 3 3 3 3 3 3 3
3 3 3 3 3 3 3 3 3 3 3 3 3 3 3 3 3 3 3 3
3 3 3 3 3 3 3 3 3 3 3 3 3 3 3 3 3 3 3 3
1 1 1 1 1 1 1 2 4 4 4 2 1 1 1 1 1 1 1 1
1 1 1 1 1 1 1 2 4 4 4 2 1 1 1 1 1 1 1 1
1 1 1 1 1 1 1 1 2 4 4 4 2 1 1 1 1 1 1 1
1 1 1 1 1 1 1 1 2 4 4 4 2 2 1 1 1 1 1 1
1 1 1 1 1 1 1 1 2 4 4 4 2 2 1 1 1 1 1 1
1 1 1 1 1 1 1 1 2 4 4 4 2 1 1 1 1 1 1 1